While you are walking around the house you notice that you can't seem to find your pet dragon Draco. You need to go find the Dragon gloves and his cage in order to catch him. If he gets out, he will go eat all the sheep in the land. You better find him quick!

Loose Dragon
An Interactive Fiction by EJ Talavera
Release 1 / Serial number 141007 / Inform 7 build 6L38 (I6/v6.33 lib 6/12N) SD

Living room
The main part of this house. This is where everyone likes to hangout. There is a 75-inch TV on the east wall and a long circular couch that surrounds the front part of the TV.  Also a glass chandelier that hangs from the ceiling.  The Kitchen is to the north, basement to the south, and the training room to the east.

You can see Stuffed Toy and Picture here.

>x TV
A TV that you and Draco like to watch movies on.  His favorite movie is How To Train Your Dragon.  Everytime he watches that movie he gets exited and shoots a random fireball.

>x chandelier
A glass chandelier that your parents bought from the best craftsman in the land named Edge.

Draco the dragon is here.

>x couch
A couch that surrounds the TV so you can watch from any view. There are some burnt spots on the couch because over Draco's over excitement.

Draco the dragon leaves.
Draco the dragon is here.

>x stuffed toy
A stuffed animal toy of a goat that Draco ripped apart this morning.

Draco the dragon leaves.

>take stuffed toy
Taken.

Draco the dragon is here.

>x picture
It's a picture of Draco when he was little.  You and him where in the training room learning how to shoot fireballs at the archery targets.

Draco the dragon leaves.

>take picture
Taken.

>x draco
You can't see any such thing.

>l
Living room
The main part of this house. This is where everyone like to hangout. There is a 75 inch TV on the east wall and a long circular couch that surrounds the front part of the TV.  Also a glass chandelier that hangs from the ceiling.  The Kitchen is to the north, basement to the south, and the training room to the east.

>n
Kitchen
A room where you cook up one the most finest dishes in the land. Learning your skills from your mother who is cook for the king. All the appliances in this room are top of the line. Living Room is to the south.

You can see Draco, Dining table, a pair of Dragon gloves, Chair and Food bowl here.

Draco the dragon leaves.

>x appliances
You can't see any such thing.

>x dining table
A table made out of pure gold. You couldn't ask for a better thing to eat on.

>take table
Let's be honest you can't carry that.

>take dragon gloves
Taken.

>x chair
A chair made out of a combination of leather and cotton. Although it seems to be missing a leg. I wonder who could've eaten that.

>take chair
Do you really want to carry that around with you?

Draco the dragon is here.

>x food bowl
A food bowl for Draco. He doesn't like eating alone so he brings it into the kitchen to eat with you.

Draco the dragon leaves.

>take draco
You can't see any such thing.

>take food bowl
Taken.

>l
Kitchen
A room where you cook up one the most finest dishes in the land. Learning your skills from your mother who is cook for the king. All the appliances in this room are top of the line. Living Room is to the south.

You can see Dining table and Chair here.

>s
Living room
The main part of this house. This is where everyone like to hangout. There is a 75 inch TV on the east wall and a long circular couch that surrounds the front part of the TV.  Also a glass chandelier that hangs from the ceiling.  The Kitchen is to the north, basement to the south, and the training room to the east.

You can see Draco here.

Draco the dragon leaves.

>s
Basement
A room that your store all the stuff  that Draco has ripped apart, chewed or burnt. Theres the first beanbag that he first ripped apart. Also his cage that you brought him home in. North is the Living room

You can see Beanbag and Cage (empty) here.

Draco the dragon is here.

>take cage
Taken.

Draco the dragon leaves.

>put on gloves
You put on the pair of Dragon gloves.

>l
Basement
A room that your store all the stuff  that Draco has ripped apart, chewed or burnt. Theres the first beanbag that he first ripped apart. Also his cage that you brought him home in. North is the Living room

You can see Beanbag here.

>take beanbag
I don't think you want to do that, it's about to fall apart.

Draco the dragon is here.

>n
Living room
The main part of this house. This is where everyone like to hangout. There is a 75 inch TV on the east wall and a long circular couch that surrounds the front part of the TV.  Also a glass chandelier that hangs from the ceiling.  The Kitchen is to the north, basement to the south, and the training room to the east.

>e
Training Room
A room where you made specifically to train Draco.  Theres ropes hanging from the cieling to help pratice his flying.  Four archery targets to helps him control where he shoots his fireballs. Also training dummies for him to fight.

You can see Draco here.

Draco the dragon leaves.

>x dummies
Dummies that knights train on, bfeore they go into battle. Each dummie has thier arm ripped off because the arm is Draco's favorite part or the human body.

Draco the dragon is here.

>put stuffed animal in cage
I didn't understand that sentence.

>e
You can't go that way.

Draco the dragon leaves.

>s
You can't go that way.

>take draco
You can't see any such thing.

>l
Training Room
A room where you made specifically to train Draco.  Theres ropes hanging from the cieling to help pratice his flying.  Four archery targets to helps him control where he shoots his fireballs. Also training dummies for him to fight.

>e
You can't go that way.

>take draco
You can't see any such thing.

>put draco in cage
You can't see any such thing.

* * *

>go n
Kitchen
A room where you cook up one the most finest dishes in the land. Learning your skills from your mother who is cook for the king. All the appliances in this room are top of the line. Living Room is to the south.

You can see Dining table, a pair of Dragon gloves, Chair and Food bowl here.

>take gloves
Taken.

>wear gloves
You put on the pair of Dragon gloves.

>s
Living room
The main part of this house. This is where everyone like to hangout. There is a 75 inch TV on the east wall and a long circular couch that surrounds the front part of the TV.  Also a glass chandelier that hangs from the ceiling.  The Kitchen is to the north, basement to the south, and the training room to the east.

You can see Stuffed Toy and Picture here.

>s
Basement
A room that your store all the suf that Draco has ripped apart, chewed or burnt. Theres the first beanbag that he first ripped apart. Also his cage that you brought him home in. North is the Living room

You can see Beanbag and Cage (empty) here.

>take cage
Taken.

>n
Living room
The main part of this house. This is where everyone like to hangout. There is a 75 inch TV on the east wall and a long circular couch that surrounds the front part of the TV.  Also a glass chandelier that hangs from the ceiling.  The Kitchen is to the north, basement to the south, and the training room to the east.

You can see Stuffed Toy and Picture here.

>e
Training Room
A room where you made specifically to train Draco.  Theres ropes hanging from the cieling to help pratice his flying.  Four archery targets to helps him control where he shoots his fireballs. Also training dummies for him to fight.

>n
Bedroom
The place where you and Draco sleep. Sometimes you have to sleep on the floor becuase he pushes you off the bed to have the whole bed to himself.

You can see Pillow and Sleep clothes here.

>s
Training Room
A room where you made specifically to train Draco.  Theres ropes hanging from the cieling to help pratice his flying.  Four archery targets to helps him control where he shoots his fireballs. Also training dummies for him to fight.

>s
You can't go that way.

>take Draco
You can't see any such thing.

* * *

>s
Basement
A room that your store all the stuff  that Draco has ripped apart, chewed or burnt. Theres the first beanbag that he first ripped apart. Also his cage that you brought him home in. North is the Living room.

You can see Beanbag and Cage (empty) here.

>close cage
It isn't something you can close.

>open cage
It isn't something you can open.

>take cage
Taken.

>x cage
 A cage that you use to hold Draco if he's ever being bad or when you want to take him on vacation. The cage is made out of platnium becuase it's always the best for your dragon.

>money
That's not a verb I recognise.

>x money
You can't see any such thing.

>n
Living room
The main part of this house. This is where everyone like to hangout. There is a 75 inch TV on the east wall and a long circular couch that surrounds the front part of the TV.  Also a glass chandelier that hangs from the ceiling.  The Kitchen is to the north, basement to the south, and the training room to the east.

You can see Draco, Stuffed Toy and Picture here.

Draco the dragon leaves.
Draco the dragon is here.

>e
Training Room
A room where you made specifically to train Draco.  Theres ropes hanging from the cieling to help pratice his flying.  Four archery targets to helps him control where he shoots his fireballs. Also training dummies for him to fight. North is Bedroom, and west is the Living room.

You can see Alfred here.

>ask alfred about the gloves
There is no reply.

>ask alfred about gloves
There is no reply.

>ask alfred about dragon gloves
Yes I might know where those gloves are, but I think I need a little cash to jog my memory.

>n
Bedroom
The place where you and Draco sleep. Sometimes you have to sleep on the floor becuase he pushes you off the bed to have the whole bed to himself. South is the Training room.

You can see Draco, Pillow, Wood drawer (closed) and Sleep clothes here.

Draco the dragon leaves.
Draco the dragon is here.

>open drawer
You open Wood drawer, revealing Money.

Draco the dragon leaves.

>take monet
You can't see any such thing.

>take money
Taken.

>s
Training Room
A room where you made specifically to train Draco.  Theres ropes hanging from the cieling to help pratice his flying.  Four archery targets to helps him control where he shoots his fireballs. Also training dummies for him to fight. North is Bedroom, and west is the Living room.

You can see Alfred here.

>give money to alfred
Oh yes the gloves are in my back pocket. Hear you go.

>i
You are carrying:
  a pair of Dragon gloves
  Cage

>wear gloves
You put on the pair of Dragon gloves.

>w
Living room
The main part of this house. This is where everyone like to hangout. There is a 75 inch TV on the east wall and a long circular couch that surrounds the front part of the TV.  Also a glass chandelier that hangs from the ceiling.  The Kitchen is to the north, basement to the south, and the training room to the east.

You can see Stuffed Toy and Picture here.

>n
Kitchen
A room where you cook up one the most finest dishes in the land. Learning your skills from your mother who is cook for the king. All the appliances in this room are top of the line. Living Room is to the south.

You can see Draco, Dining table, Chair and Food bowl here.

Draco the dragon leaves.

>s
Living room
The main part of this house. This is where everyone like to hangout. There is a 75 inch TV on the east wall and a long circular couch that surrounds the front part of the TV.  Also a glass chandelier that hangs from the ceiling.  The Kitchen is to the north, basement to the south, and the training room to the east.

You can see Stuffed Toy and Picture here.

Draco the dragon is here.

>take draco
Taken.

>pur draco in cage
That's not a verb I recognise.

>put draco in cage
You put Draco into Cage.

    *** You caught Draco before he escaped. Congratulations!!!!! ***

Would you like to RESTART, RESTORE a saved game, QUIT or UNDO the last command?

>restore
Restore failed.

Would you like to RESTART, RESTORE a saved game, QUIT or UNDO the last command?

* * *

>take TV
I dont think your strong enough for that.

>x toy
A stuffed animal toy of a goat that Draco ripped apart this morning.

* * *

>e
Training Room
A room where you made specifically to train Draco.  Theres ropes hanging from the cieling to help pratice his flying.  Four archery targets to helps him control where he shoots his fireballs. Also training dummies for him to fight.

You can see Alfred and Draco here.

Draco the dragon leaves.

>ask alfred about draco
No sir, I haven't seen Draco around here recently. He's probaly wondering around. I think I closed all the windows. Better find him quick.

>ask alfred about Dragon gloves
Yes I might know where those gloves are, but I think I need a little cash to jog my memory.

Draco the dragon is here.

>n
Bedroom
The place where you and Draco sleep. Sometimes you have to sleep on the floor becuase he pushes you off the bed to have the whole bed to himself.

You can see Pillow, Wood drawer (closed) and Sleep clothes here.

>open drawer
You open Wood drawer, revealing Money.

Draco the dragon is here.

>take money
Taken.

Draco the dragon leaves.

>s
Training Room
A room where you made specifically to train Draco.  Theres ropes hanging from the cieling to help pratice his flying.  Four archery targets to helps him control where he shoots his fireballs. Also training dummies for him to fight.

You can see Draco and Alfred here.

Draco the dragon leaves.

>ask alfred about dragon gloves
Yes I might know where those gloves are, but I think I need a little cash to jog my memory.

>give money to alfred
Oh yes the gloves are in my back pocket. Hear you go.

>i
You are carrying:
  a pair of Dragon gloves

>x dragon gloves
A pair of Dragon gloves that are made out of sturdy, thick, fireproof material. It looks like if you wore them they would protect your hands from all sorts of things. Like Dragons.

>wear gloves
You put on the pair of Dragon gloves.

* * *

>e
Training Room
A room where you made specifically to train Draco.  Theres ropes hanging from the cieling to help pratice his flying.  Four archery targets to helps him control where he shoots his fireballs. Also training dummies for him to fight.

You can see Alfred and Draco here.

Draco the dragon leaves.

>talk to alred
That's not a verb I recognise.

>ask alfred about the Draco
There is no reply.

>Ask alfred
(for Alfred)
(Alfred first taking Alfred)
Alfred has better things to do.

>ask Alfred about Draco
No sir, I haven't seen Draco around here recently. He's probaly wondering around. I think I closed all the windows. Better find him quick.

Draco the dragon is here.

* * *

>n
Kitchen
A room where you cook up one the most finest dishes in the land. Learning your skills from your mother who is cook for the king. All the appliances in this room are top of the line. Living Room is to the south.

You can see Dining table, Chair and Food bowl here.

>s
Living room
The main part of this house. This is where everyone likes to hangout. There is a 75-inch TV on the east wall and a long circular couch that surrounds the front part of the TV.  Also a glass chandelier that hangs from the ceiling.  The Kitchen is to the north, basement to the south, and the training room to the east.

You can see Draco, Stuffed Toy and Picture here.

Draco the dragon leaves.

>s
Basement
A room that your store all the stuff that Draco has ripped apart, chewed or burnt. There's the first beanbag that he first ripped apart. Also his cage that you brought him home in. North is the Living room.

You can see Beanbag and Cage (empty) here.

Draco the dragon is here.

>n
Living room

>e
Training Room

>n
Bedroom

* * *

>s
Basement
A room that your store all the stuff that Draco has ripped apart, chewed or burnt. There's the first beanbag that he first ripped apart. Also his cage that you brought him home in. North is the Living room.

You can see Beanbag and Cage (empty) here.

Draco the dragon is here.

>take cage
Taken.

Draco the dragon leaves.

>n
Living room
The main part of this house. This is where everyone likes to hangout. There is a 75-inch TV on the east wall and a long circular couch that surrounds the front part of the TV.  Also a glass chandelier that hangs from the ceiling.  The Kitchen is to the north, basement to the south, and the training room to the east.

You can see Stuffed Toy and Picture here.

>e
Training Room
A room where you made specifically to train Draco.  There are ropes hanging from the ceiling to help practice his flying.  Four archery targets to help him control where he shoots his fireballs. Also training dummies for him to fight. North is Bedroom, and west is the Living room.

You can see Alfred here.

>ask alfred about Dragon gloves
Yes I might know where those gloves are, but I think I need a little cash to jog my memory.

Draco the dragon is here.

>n
Bedroom
The place where you and Draco sleep. Sometimes you have to sleep on the floor because he pushes you off the bed to have the whole bed to himself. South is the Training room.

You can see Pillow, Wood drawer (closed) and Sleep clothes here.

>open drawer
You open Wood drawer, revealing Money.

>take money
Taken.

Draco the dragon is here.

>s
Training Room
A room where you made specifically to train Draco.  There are ropes hanging from the ceiling to help practice his flying.  Four archery targets to help him control where he shoots his fireballs. Also training dummies for him to fight. North is Bedroom, and west is the Living room.

You can see Alfred here.

Draco the dragon is here.

>give money to alfred
Oh yes the gloves are in my back pocket. Here you go.

Draco the dragon leaves.
Draco the dragon is here.

>put on dragon gloves
You put on the pair of Dragon gloves.

Draco the dragon leaves.

>n
Bedroom
The place where you and Draco sleep. Sometimes you have to sleep on the floor because he pushes you off the bed to have the whole bed to himself. South is the Training room.

You can see Draco, Pillow, Wood drawer (empty) and Sleep clothes here.

Draco the dragon leaves.

>s
Training Room
A room where you made specifically to train Draco.  There are ropes hanging from the ceiling to help practice his flying.  Four archery targets to help him control where he shoots his fireballs. Also training dummies for him to fight. North is Bedroom, and west is the Living room.

You can see Alfred here.

Draco the dragon is here.

>pick up dragon
You already have that.

Draco the dragon leaves.

>n
Bedroom
The place where you and Draco sleep. Sometimes you have to sleep on the floor because he pushes you off the bed to have the whole bed to himself. South is the Training room.

You can see Pillow, Wood drawer (empty) and Sleep clothes here.

>s
Training Room
A room where you made specifically to train Draco.  There are ropes hanging from the ceiling to help practice his flying.  Four archery targets to help him control where he shoots his fireballs. Also training dummies for him to fight. North is Bedroom, and west is the Living room.

You can see Alfred here.

>s
You can't go that way.

>s
You can't go that way.

>s
You can't go that way.

Draco the dragon is here.

>pick up draco
Taken.

* * *

>n
Kitchen
A room where you cook up one the most finest dishes in the land. Learning your skills from your mother who is cook for the king. All the appliances in this room are top of the line. Living Room is to the south.

You can see Dining table, Chair and Food bowl here.

>take gloves
Taken.

Draco the dragon leaves.

>s
Living room
The main part of this house. This is where everyone like to hangout. There is a 75 inch TV on the east wall and a long circular couch that surrounds the front part of the TV.  Also a glass chandelier that hangs from the ceiling.  The Kitchen is to the north, basement to the south, and the training room to the east.

You can see Stuffed Toy and Picture here.

* * *

>e
Training Room
A room where you made specifically to train Draco.  Theres ropes hanging from the cieling to help pratice his flying.  Four archery targets to helps him control where he shoots his fireballs. Also training dummies for him to fight.

>s
You can't go that way.

Draco the dragon is here.

>put on gloves
You put on the pair of Dragon gloves.

Draco the dragon leaves.

>n
Bedroom
The place where you and Draco sleep. Sometimes you have to sleep on the floor becuase he pushes you off the bed to have the whole bed to himself.

You can see Pillow and Sleep clothes here.

* * *

>s
You can't go that way.

>w
Living room
The main part of this house. This is where everyone like to hangout. There is a 75 inch TV on the east wall and a long circular couch that surrounds the front part of the TV.  Also a glass chandelier that hangs from the ceiling.  The Kitchen is to the north, basement to the south, and the training room to the east.

You can see Stuffed Toy and Picture here.

>n
Kitchen
A room where you cook up one the most finest dishes in the land. Learning your skills from your mother who is cook for the king. All the appliances in this room are top of the line. Living Room is to the south.

You can see Dining table, Chair and Food bowl here.

Draco the dragon is here.

>put Draco in cage
(first taking Draco)
You put Draco into Cage.

You win!

    *** The End ***

Would you like to RESTART, RESTORE a saved game, QUIT or UNDO the last command?

* * *

>take gloves
Taken.

Draco the dragon leaves.

>put on gloves
You put on the pair of Dragon gloves.

>s
Living room
The main part of this house. This is where everyone like to hangout. There is a 75 inch TV on the east wall and a long circular couch that surrounds the front part of the TV.  Also a glass chandelier that hangs from the ceiling.  The Kitchen is to the north, basement to the south, and the training room to the east.

You can see Draco, Stuffed Toy and Picture here.

Draco the dragon leaves.

>s
Basement
A room that your store all the stuff  that Draco has ripped apart, chewed or burnt. Theres the first beanbag that he first ripped apart. Also his cage that you brought him home in. North is the Living room

You can see Beanbag and Cage (empty) here.

>take cage
Taken.

Draco the dragon is here.

>take draco
Taken.

>put draco in cage
You put Draco into Cage.

    *** You caught Draco before he escaped. Congratulations!!!!! ***

Would you like to RESTART, RESTORE a saved game, QUIT or UNDO the last command?

* * *

>take gloves
Taken.

Draco the dragon leaves.

>wear gloves
You put on the pair of Dragon gloves.

Draco the dragon leaves leaves.

>take Draco
You can't see any such thing.

>s
Living room
The main part of this house. This is where everyone like to hangout. There is a 75 inch TV on the east wall and a long circular couch that surrounds the front part of the TV.  Also a glass chandelier that hangs from the ceiling.  The Kitchen is to the north, basement to the south, and the training room to the east.

You can see Stuffed Toy and Picture here.

>take draco
You can't see any such thing.

>s
Basement
A room that your store all the suf that Draco has ripped apart, chewed or burnt. Theres the first beanbag that he first ripped apart. Also his cage that you brought him home in. North is the Living room

You can see Draco, Beanbag and Cage (empty) here.

Draco the dragon leaves leaves.

>n
Living room
The main part of this house. This is where everyone like to hangout. There is a 75 inch TV on the east wall and a long circular couch that surrounds the front part of the TV.  Also a glass chandelier that hangs from the ceiling.  The Kitchen is to the north, basement to the south, and the training room to the east.

You can see Draco, Stuffed Toy and Picture here.

Draco the dragon leaves leaves.

>e
Training Room
A room where you made specifically to train Draco.  Theres ropes hanging from the cieling to help pratice his flying.  Four archery targets to helps him control where he shoots his fireballs. Also training dummies for him to fight.

You can see Draco here.

Draco the dragon leaves leaves.

>n
Bedroom
The place where you and Draco sleep. Sometimes you have to sleep on the floor becuase he pushes you off the bed to have the whole bed to himself.

You can see Pillow and Sleep clothes here.

>s
Training Room
A room where you made specifically to train Draco.  Theres ropes hanging from the cieling to help pratice his flying.  Four archery targets to helps him control where he shoots his fireballs. Also training dummies for him to fight.

Draco the dragon is here.

>s
You can't go that way.

Draco the dragon leaves leaves.

>take Draco
You can't see any such thing.

>n
Bedroom
The place where you and Draco sleep. Sometimes you have to sleep on the floor becuase he pushes you off the bed to have the whole bed to himself.

You can see Pillow and Sleep clothes here.

>s
Training Room
A room where you made specifically to train Draco.  Theres ropes hanging from the cieling to help pratice his flying.  Four archery targets to helps him control where he shoots his fireballs. Also training dummies for him to fight.

You can see Draco here.

Draco the dragon leaves leaves.

>w
Living room
The main part of this house. This is where everyone like to hangout. There is a 75 inch TV on the east wall and a long circular couch that surrounds the front part of the TV.  Also a glass chandelier that hangs from the ceiling.  The Kitchen is to the north, basement to the south, and the training room to the east.

You can see Stuffed Toy and Picture here.

>s
Basement
A room that your store all the suf that Draco has ripped apart, chewed or burnt. Theres the first beanbag that he first ripped apart. Also his cage that you brought him home in. North is the Living room

You can see Draco, Beanbag and Cage (empty) here.

Draco the dragon leaves leaves.

* * *

>n
Kitchen
A room where you cook up one the most finest dishes in the land. Learning your skills from your mother who is cook for the king. All the appliances in this room are top of the line. Living Room is to the south.

You can see Dining table, Chair and Food bowl here.

>x dining table
A table made out of pure gold. You couldn't ask for a better thing to eat on.

>x gloves
A pair of Dragon gloves that are made out of sturdy, thick, fireproof material. It looks like if you wore them they would protect your hands from all sorts of things. Like Dragons.

>x food bowl
A food bowl for Draco. He doesn't like eating alone so he brings it into the kitchen to eat with you.

>x chair
A chair made out of a combination of leather and cotton. Although it seems to be missing a leg. I wonder who could've eaten that.

>ufuccking dragon
That's not a verb I recognise.

I beg your pardon?

I beg your pardon?

>take gloves
Taken.

>take dining table
Let's be honest you can't carry that.

Draco the dragon is here.

>take draco the dragon
I only understood you as far as wanting to take Draco.

>take draco
You look at his claws and teeth and think otherwise.

Draco the dragon leaves.
Draco the dragon is here.

>take chair
Do you really want to carry that around with you?

Draco the dragon leaves.

>take food bowl
Taken.

>/s
That's not a verb I recognise.

>s
Living room
The main part of this house. This is where everyone like to hangout. There is a 75 inch TV on the east wall and a long circular couch that surrounds the front part of the TV.  Also a glass chandelier that hangs from the ceiling.  The Kitchen is to the north, basement to the south, and the training room to the east.

You can see Stuffed Toy and Picture here.

>x tv
A TV that you and Draco like to watch movies on.  His favorite movie is How To Train Your Dragon.  Everytime he watches that movie he gets exited and shoots a random fireball.

>x couch
You can't see any such thing.

>x chandelier
A glass chandelier that your parents bought from the best craftsman in the land named Edge.

Draco the dragon is here.

>put gloves on
You put on the pair of Dragon gloves.

Draco the dragon leaves.

>e
Training Room
A room where you made specifically to train Draco.  Theres ropes hanging from the cieling to help pratice his flying.  Four archery targets to helps him control where he shoots his fireballs. Also training dummies for him to fight.

>x ropes
Ropes that are at least one foot thick. From constant training some of the ropes are scratched trough from the sharpness of Draco's wings.

>take tropes
You can't see any such thing.

>take ropes
That's hardly portable.

>x archery targets
Archery targets given to you by the best archers in the land. One of Draco's favorite training obstacles.

>take archery targets
That's hardly portable.

>x dummies
Dummies that knights train on, bfeore they go into battle. Each dummie has thier arm ripped off because the arm is Draco's favorite part or the human body.

>take dummies
That's hardly portable.

Draco the dragon is here.

>s
You can't go that way.

Draco the dragon leaves.

>w
Living room
The main part of this house. This is where everyone like to hangout. There is a 75 inch TV on the east wall and a long circular couch that surrounds the front part of the TV.  Also a glass chandelier that hangs from the ceiling.  The Kitchen is to the north, basement to the south, and the training room to the east.

You can see Stuffed Toy and Picture here.

>s
Basement
A room that your store all the suf that Draco has ripped apart, chewed or burnt. Theres the first beanbag that he first ripped apart. Also his cage that you brought him home in. North is the Living room

You can see Beanbag and Cage (empty) here.

Draco the dragon is here.

>take cage
Taken.

Draco the dragon leaves.

>x beanbag
His first beanbag that you bought for him. It was supposed to be a bed for him but it ended up being his first chew toy

Draco the dragon is here.

>take draco
Taken.

Draco scratches and bites. It is hard to carry him.
With no effort at all, Draco escapes from your grasp, he makes a snarl at you as he departs.

>fuck you draco stupid cunt
That's not a verb I recognise.

>il fk u up m8 1v1 ez raid
That's not a verb I recognise.

>take draco
You can't see any such thing.

>take beanbag
I don't think you want to do that, it's about to fall apart.

>s
You can't go that way.

>w
You can't go that way.

>e
You can't go that way.

>n
Living room
The main part of this house. This is where everyone like to hangout. There is a 75 inch TV on the east wall and a long circular couch that surrounds the front part of the TV.  Also a glass chandelier that hangs from the ceiling.  The Kitchen is to the north, basement to the south, and the training room to the east.

You can see Stuffed Toy and Picture here.

>n
Kitchen
A room where you cook up one the most finest dishes in the land. Learning your skills from your mother who is cook for the king. All the appliances in this room are top of the line. Living Room is to the south.

You can see Dining table and Chair here.

>s
Living room
The main part of this house. This is where everyone like to hangout. There is a 75 inch TV on the east wall and a long circular couch that surrounds the front part of the TV.  Also a glass chandelier that hangs from the ceiling.  The Kitchen is to the north, basement to the south, and the training room to the east.

You can see Stuffed Toy and Picture here.

>e
Training Room
A room where you made specifically to train Draco.  Theres ropes hanging from the cieling to help pratice his flying.  Four archery targets to helps him control where he shoots his fireballs. Also training dummies for him to fight.

>w
Living room
The main part of this house. This is where everyone like to hangout. There is a 75 inch TV on the east wall and a long circular couch that surrounds the front part of the TV.  Also a glass chandelier that hangs from the ceiling.  The Kitchen is to the north, basement to the south, and the training room to the east.

You can see Stuffed Toy and Picture here.

>n
Kitchen
A room where you cook up one the most finest dishes in the land. Learning your skills from your mother who is cook for the king. All the appliances in this room are top of the line. Living Room is to the south.

You can see Dining table and Chair here.

>n
You can't go that way.

>ew
That's not a verb I recognise.

>w
You can't go that way.

Draco the dragon is here.

>put draco in cage
(first taking Draco)
You put Draco into Cage.

You win!

    *** The End ***

Would you like to RESTART, RESTORE a saved game, QUIT or UNDO the last command?

* * *

>x toy
A stuffed animal toy of a goat that Draco ripped apart this morning.

>take toy
Taken.

>x picute
You can't see any such thing.

>x picture
It's a picture of Draco when he was little.  You and him where in the training room learning how to shoot fireballs at the archery targets.

>take picture
Taken.

>i
You are carrying:
  Picture
  Stuffed Toy

>l
Living room
The main part of this house. This is where everyone like to hangout. There is a 75 inch TV on the east wall and a long circular couch that surrounds the front part of the TV.  Also a glass chandelier that hangs from the ceiling.  The Kitchen is to the north, basement to the south, and the training room to the east.

>x TV
A TV that you and Draco like to watch movies on.  His favorite movie is How To Train Your Dragon.  Everytime he watches that movie he gets exited and shoots a random fireball.

Draco the dragon is here.

* * *

>x toy
A stuffed animal toy of a goat that Draco ripped apart this morning.

>x piture
You can't see any such thing.

>x picture
It's a picture of Draco when he was little.  You and him where in the training room learning how to shoot fireballs at the archery targets.

Draco the dragon is here.

>n
Kitchen
A room where you cook up one the most finest dishes in the land. Learning your skills from your mother who is cook for the king. All the appliances in this room are top of the line. Living Room is to the south.

You can see Dining table, Chair and Food bowl here.

>x Dining Table
A table made out of pure gold. You couldn't ask for a better thing to eat on.

Draco the dragon is here.

>Take table
Let's be honest you can't carry that.

Draco the dragon leaves.

>take chair
Do you really want to carry that around with you?

>take bowl
Taken.

>s
Living room
The main part of this house. This is where everyone like to hangout. There is a 75 inch TV on the east wall and a long circular couch that surrounds the front part of the TV.  Also a glass chandelier that hangs from the ceiling.  The Kitchen is to the north, basement to the south, and the training room to the east.

You can see Stuffed Toy and Picture here.

>s
Basement
A room that your store all the stuff  that Draco has ripped apart, chewed or burnt. Theres the first beanbag that he first ripped apart. Also his cage that you brought him home in. North is the Living room

You can see Beanbag and Cage (empty) here.

>take cage
Taken.

>put bowl in cage
You put Food bowl into Cage.

>put draco in cage
You can't see any such thing.

>take bowl out of cage
I only understood you as far as wanting to take Food bowl.

>take bowl
Taken.

>drop bowl
Dropped.

>n
Living room
The main part of this house. This is where everyone like to hangout. There is a 75 inch TV on the east wall and a long circular couch that surrounds the front part of the TV.  Also a glass chandelier that hangs from the ceiling.  The Kitchen is to the north, basement to the south, and the training room to the east.

You can see Stuffed Toy and Picture here.

>e
Training Room
A room where you made specifically to train Draco.  Theres ropes hanging from the cieling to help pratice his flying.  Four archery targets to helps him control where he shoots his fireballs. Also training dummies for him to fight.

You can see Alfred here.

Draco the dragon is here.

>ask alfred about Dragon gloves
Yes I might know where those gloves are, but I think I need a little cash to jog my memory.

Draco the dragon leaves.
Draco the dragon is here.

>n
Bedroom
The place where you and Draco sleep. Sometimes you have to sleep on the floor becuase he pushes you off the bed to have the whole bed to himself.

You can see Pillow, Wood drawer (closed) and Sleep clothes here.

>x drawer
A drawer to store things.

>open drawer
You open Wood drawer, revealing Money.

>take onety
You can't see any such thing.

>take money
Taken.

Draco the dragon is here.

>s
Training Room
A room where you made specifically to train Draco.  Theres ropes hanging from the cieling to help pratice his flying.  Four archery targets to helps him control where he shoots his fireballs. Also training dummies for him to fight.

You can see Alfred here.

>s
You can't go that way.

>give money to alfred
Oh yes the gloves are in my back pocket. Hear you go.

* * *

>i
You are carrying:
  a pair of Dragon gloves
  Cage

>waer gloves
That's not a verb I recognise.

>wear gloves
You put on the pair of Dragon gloves.

>w
Living room
The main part of this house. This is where everyone like to hangout. There is a 75 inch TV on the east wall and a long circular couch that surrounds the front part of the TV.  Also a glass chandelier that hangs from the ceiling.  The Kitchen is to the north, basement to the south, and the training room to the east.

You can see Draco, Stuffed Toy and Picture here.

Draco the dragon leaves.

>n
Kitchen
A room where you cook up one the most finest dishes in the land. Learning your skills from your mother who is cook for the king. All the appliances in this room are top of the line. Living Room is to the south.

You can see Draco, Dining table and Chair here.

Draco the dragon leaves.

>s
Living room
The main part of this house. This is where everyone like to hangout. There is a 75 inch TV on the east wall and a long circular couch that surrounds the front part of the TV.  Also a glass chandelier that hangs from the ceiling.  The Kitchen is to the north, basement to the south, and the training room to the east.

You can see Draco, Stuffed Toy and Picture here.

Draco the dragon leaves.

>s
Basement
A room that your store all the stuff  that Draco has ripped apart, chewed or burnt. Theres the first beanbag that he first ripped apart. Also his cage that you brought him home in. North is the Living room

You can see Food bowl and Beanbag here.

>n
Living room
The main part of this house. This is where everyone like to hangout. There is a 75 inch TV on the east wall and a long circular couch that surrounds the front part of the TV.  Also a glass chandelier that hangs from the ceiling.  The Kitchen is to the north, basement to the south, and the training room to the east.

You can see Stuffed Toy and Picture here.

>n
Kitchen
A room where you cook up one the most finest dishes in the land. Learning your skills from your mother who is cook for the king. All the appliances in this room are top of the line. Living Room is to the south.

You can see Draco, Dining table and Chair here.

Draco the dragon leaves.

>s
Living room
The main part of this house. This is where everyone like to hangout. There is a 75 inch TV on the east wall and a long circular couch that surrounds the front part of the TV.  Also a glass chandelier that hangs from the ceiling.  The Kitchen is to the north, basement to the south, and the training room to the east.

You can see Stuffed Toy and Picture here.

>n
Kitchen
A room where you cook up one the most finest dishes in the land. Learning your skills from your mother who is cook for the king. All the appliances in this room are top of the line. Living Room is to the south.

You can see Dining table and Chair here.

* * *

>n
You can't go that way.

>s
Living room
The main part of this house. This is where everyone like to hangout. There is a 75 inch TV on the east wall and a long circular couch that surrounds the front part of the TV.  Also a glass chandelier that hangs from the ceiling.  The Kitchen is to the north, basement to the south, and the training room to the east.

You can see Stuffed Toy and Picture here.

>e
Training Room
A room where you made specifically to train Draco.  Theres ropes hanging from the cieling to help pratice his flying.  Four archery targets to helps him control where he shoots his fireballs. Also training dummies for him to fight.

You can see Draco and Alfred here.

Draco the dragon leaves.

>n
Bedroom
The place where you and Draco sleep. Sometimes you have to sleep on the floor becuase he pushes you off the bed to have the whole bed to himself.

You can see Pillow, Wood drawer (empty) and Sleep clothes here.

>s
Training Room
A room where you made specifically to train Draco.  Theres ropes hanging from the cieling to help pratice his flying.  Four archery targets to helps him control where he shoots his fireballs. Also training dummies for him to fight.

You can see Alfred here.

Draco the dragon is here.

>take draco
Taken.

* * *

>x chandelier
A glass chandelier that your parents bought from the best craftsman in the land named Edge.

>take chandelier
That's hardly portable.

>x toy
A stuffed animal toy of a goat that Draco ripped apart this morning.